##########
#........#
###....###
#....@...#
#..#.....#
#........#
#...#....#
#...###..#
#.....#..#
##########